  ##### ##### ##### ####### ##### ### ###
 #.....#.....#.....#.......#.....#...#...#
 #.###.#.###.#.###.#.#.#####.#.#.#.#.#.#.#
 #.#.#.#..X#.....#.#.#.......#.#.#.#...#.#
 #.#.#.#####.#####.#.#########.###.#####.#
 #...#.....#.#.....#.#...#...#...#.#.#...#
  ##.#####.###.###.#.#.#.#.#.###.#.#.#.#.#
 #.#.#...#.#...#...#.#.#...#...#.#...#.#.#
 #.#.#.###.#.#######.#.#######.#.###.#.##
 #.#.#.#...#.#.....#.#...#.....#.....#...#
 #.#.#.#.###.#.###.#.###.###.######## ##.#
 #...#.#...#.....#.#...#...#.#...#...#.#.#
 #.###.###.#####.#.###.###.#.#.#.#.#.#.#.#
 #.....#.#.....#.#.........#...#.#.#...#.#
  ####.#.#####.#######.#### ####.#.#####.#
 #...#.#.#...#.#.....#.#...#...#...#.....#
 #.#.#.#.#.#.#.#.###.#.#.#.#.#.#####.###.#
 #.#.#.#...#.#...#...#.#.#...#.......#...#
 #.#.#.#####.## ##.#####.#.###########.##
 #.#.#.........#.#.....#.#.#...#.....#.#.#
 #.#.#########.#.#####.#.###.#.###.###.#.#
 #.#.#.......#.#.....#^#.#...#...#.....#.#
 #.###.#.#####.#.###.###.#.#####.###.###.#
 #.#...#.....#...#...#...#.....#...#.....#
 #.#.#######.#####.#####.#####.###.#####.#
 #.#.#.....#.....#.....#...#...#.#.#.....#
 #.#.###.#######.#####.#.###.###.#.######
 #.#.#...#.....#.....#.#.........#.#.....#
 #.#.#.###.###.###.###.###########.#.###.#
 #.#.#.......#...#...#...........#.....#.#
 #.#.###.#######.###.###########.#######.#
 #.#...#...#.....#.#...#.......#.....#...#
 #.###.#####.###.#.###.#.###.#.#####.#.##
 #...#.#.....#...#...#.#.#.#.#...#...#...#
  ##.#.#.#####.###.#.#.#.#.#.#####.#####.#
 #...#.#...#...#...#.#.#...#.....#.#.....#
 #.###.#.#.###.#####.#.###.#####.#.#.###.#
 #.....#.#...#...#...#.....#.#...#...#.#.#
 #.#########.###.#.#.#######.#.#######.#.#
 #...........#.....#.........#...........#
  ########### ##### ######### ###########